42
42
111111111111111111111111111111111111111111
122221122221122221122221122221122221122221
123322123322123322123322123322123322123322
124532124532124532124532124532124532124532
122221122221122221122221122221122221122221
111111111111111111111111111111111111111111
111111111111111111111111111111111111111111
122221122221122221122221122221122221122221
123322123322123322123322123322123322123322
124532124532124532124532124532124532124532
122221122221122221122221122221122221122221
111111111111111111111111111111111111111111
111111111111111111111111111111111111111111
122221122221122221122221122221122221122221
123322123322123322123322123322123322123322
124532124532124532124532124532124532124532
122221122221122221122221122221122221122221
111111111111111111111111111111111111111111
111111111111111111111111111111111111111111
122221122221122221122221122221122221122221
123322123322123322123322123322123322123322
124532124532124532124532124532124532124532
122221122221122221122221122221122221122221
111111111111111111111111111111111111111111
111111111111111111111111111111111111111111
122221122221122221122221122221122221122221
123322123322123322123322123322123322123322
124532124532124532124532124532124532124532
122221122221122221122221122221122221122221
111111111111111111111111111111111111111111
111111111111111111111111111111111111111111
122221122221122221122221122221122221122221
123322123322123322123322123322123322123322
124532124532124532124532124532124532124532
122221122221122221122221122221122221122221
111111111111111111111111111111111111111111
111111111111111111111111111111111111111111
122221122221122221122221122221122221122221
123322123322123322123322123322123322123322
124532124532124532124532124532124532124532
122221122221122221122221122221122221122221
111111111111111111111111111111111111111111